#####################
#       #       #   #
### ### # ### # ### #
#   #   # #   # #   #
# ##### ### ### # # #
#     #   # # #   # #
##### ### # # ##### #
#     #   # # #     #
# ##### ### # # #####
#   # #     # #     #
### # ####### ##### #
#   #               #
#####################